10 10
##########
#1#000##0#
#0#0#00#0#
#000##000#
#0#0#00#0#
#00###0#0#
#0#0000#0#
#00###0#0#
##0####20#
##########