7 7
#######
#1#000#
#0#0###
#000#0#
#0#000#
#0#0#2#
#######